# painlessMesh library keywords

# Classes (KEYWORD1)
painlessMesh	KEYWORD1
Scheduler	KEYWORD1
Task	KEYWORD1

# Methods and Functions (KEYWORD2)
init	KEYWORD2
update	KEYWORD2
sendBroadcast	KEYWORD2
sendSingle	KEYWORD2
onReceive	KEYWORD2
onNewConnection	KEYWORD2
onChangedConnections	KEYWORD2
onNodeTimeAdjusted	KEYWORD2
getNodeList	KEYWORD2
getNodeId	KEYWORD2
getNodeTime	KEYWORD2
setDebugMsgTypes	KEYWORD2
subConnectionJson	KEYWORD2
asNodeTree	KEYWORD2

# Alteriom Extensions (KEYWORD1)
SensorPackage	KEYWORD1
CommandPackage	KEYWORD1
StatusPackage	KEYWORD1

# Alteriom Methods (KEYWORD2)
addTo	KEYWORD2
jsonObjectSize	KEYWORD2

# Constants (LITERAL1)
MESH_PREFIX	LITERAL1
MESH_PASSWORD	LITERAL1
MESH_PORT	LITERAL1
TASK_SECOND	LITERAL1
TASK_MINUTE	LITERAL1
TASK_HOUR	LITERAL1
TASK_FOREVER	LITERAL1
ERROR	LITERAL1
STARTUP	LITERAL1
CONNECTION	LITERAL1
SYNC	LITERAL1
COMMUNICATION	LITERAL1
GENERAL	LITERAL1
MSG_TYPES	LITERAL1
REMOTE	LITERAL1
DEBUG	LITERAL1